0000000000000000000000000000000000000000000000000000000000000000000000000000000000000000000000000000
0000000000000000000000000000000000000000000000000000000000000000000000000000000000000000000000000000
0000000000000000000000000000000000000000000000000000000000000000000000000000000000000000000000000000
0000000000000000000000000000000000000000000000000000000000000000000000000000000000000000000000000000
0000000000000000000000000000000000000000000000000000000000000000000000000000000000000000000000000000
0000001111111111111111110000000000000000000000000000000011111111111111111100000000000000000000000000
0011111111111111111111111110000000000000000000000000111111111111111111111111100000000000000000000000
0001111111111111111111111111111111110000000000000000011111111111111111111111111111111100000000000000
0001111111111111111111111111111111110000000000000000011111111111111111111111111111111100000000000000
0001111111111111111111111111111111100000000000000000011111111111111111111111111111111000000000000000
0000111111111111111111111111111111110000000000000000001111111111111111111111111111111111000000000000
0000011111111111111111111111111111100000000000000000001111111111111111111111111111111111000000000000
0000011111111111111111111111111111000000000000000000001111111111111111111111111111111111000000000000
0000000011111111111111111111111110000000000000000000001111111111111111111111111111111111000000000000
0000000001111111111111111111111100000000000000000000001111111111111111111111111111111111000000000000
0000000001111111111111111111111100000000000000000000000000011111111111111111111110000000000000000000
0000000001111111111111111111111000000000000000000000000000011111111111111111111110000000000000000000
0000000000111111111111111111110000000000000000000000000000000111111111111111110000000000000000000000
0000000000011111111111111111000000000000000000000000000000000111111111111111110000000000000000000000
0000000000001111111111110000000000000000000000000000000000000111111111111111110000000000000000000000
0000000000001111111111110000000000000000000000000000000000000111111111111111110000000000000000000000
0000000000001111111111100000000000000000000000000000000000000111111111111111110000000000000000000000
0000000000000111111110000000000000000000000000000000000000000001111111100000000000000000000000000000
0000000000000111111100000000000000000000000000000000000000000001111111100000000000000000000000000000
0000000000000111111000000000000000000000000000000000000000000001111111100000000000000000000000000000
0000000000000011110000000000000000000000000000000000000000000001111111100000000000000000000000000000
0000000000000001100000000000000000000000000000000000000000000000011000000000000000000000000000000000
0000000000000000000000000000000000000000000000000000000000000000011000000000000000000000000000000000
0000000000000000000000000000000000000000000000000000000000000000000000000000000000000000000000000000
0000000000000000000000000000000000000000000000000000000000000000000000000000000000000000000000000000
0000000000000000000000000000000000000000000000000000000000000000000000000000000000000000000000000000
0000000000000000000000000000000000000000000000000000000000000000000000000000000000000000000000000000
0000000000000000000000000000000000000000000000000000000000000000000000000000000000000000000000000000
0000000000000000000000000000000000000000000000000000000000000000000000000000000000000000000000000000
0000000000000000000000000000000000000000000000000000000000000000000000000000000000000000000000000000
0000000000000000000000000000000000000000000000000000000000000000000000000000000000000000000000000000
0000000000000000000000000000000000000000000000000000000000000000000000000000000000000000000000000000
0000000000000000000000000000000000000000000000000000000000000000000000000000000000000000000000000000
0000000000011100000000000000000000000000000000000000000000000000000000000000000000000000000000000000
0000000000111111000000000000000000000000000000000000000000000000000000000000000000000000000000000000
0000000000111000000000000000000000000000000000000000000000000000000000000000000000000000000000000000
0000000000000000000000000000000000000000000000000000000000000000000000000000000000000000000000000000
0000000000000000000000000000000011100000000000000000000000000000000000000000000000000000000000000000
0000000000000000000000000000000111110000000000000000000000000000000000000000000000000000000000000000
0000000000011111111000000000000011100000000000000000000000000000000000000000000000000000000000000000
0000000000001111111111100000000000000000000000000000000000000000000000000000000000000000000000000000
0000000000000000000000000000000000000000000000000000000000000000000000000000000000000000000000000000
0000000000000000000000000000000000000000000000000000000000000000000000000000000000000000000000000000
0000000000000000000000000000000000000000000000000000000000000000000000000000000000000000000000000000
0000000000000000000000000000000000000000000000000000000000000000000000000000000000000000000000000000
0000000000000000000000000000000000000000000000000000000000000000000000000000000000000000000000000000
0000000000000000000000000000000000000000000000000000000000000000000000000000000000000000000000000000
0000000000000000000000000000000000000000000000000000000000000000000000000000000000000000000000000000
0000000000000000000000000000000000000000000000000000000000000000000000000000000000000000000000000000
0000000000000000000000000000000000000000000000000000000000000000000000000000000000000000000000000000
0000001111111111111111110000000000000000000000000000000011111111111111111100000000000000000000000000
0011111111111111111111111110000000000000000000000000111111111111111111111111100000000000000000000000
0001111111111111111111111111111111110000000000000000011111111111111111111111111111111100000000000000
0001111111111111111111111111111111110000000000000000011111111111111111111111111111111100000000000000
0001111111111111111111111111111111100000000000000000011111111111111111111111111111111000000000000000
0000111111111111111111111111111111111100000000000000001111111111111111111111111111111111000000000000
0000011111111111111111111111111111100000000000000000001111111111111111111111111111111111000000000000
0000011111111111111111111111111111110000000000000000001111111111111111111111111111111111000000000000
0000000011111111111111111111111111000000000000000000001111111111111111111111111111111111000000000000
0000000001111111111111111111111100000000000000000000001111111111111111111111111111111111000000000000
0000000001111111111111111111111100000000000000000000000000011111111111111111111110000000000000000000
0000000001111111111111111111111000000000000000000000000000011111111111111111111110000000000000000000
0000000000111111111111111111110000000000000000000000000000000111111111111111110000000000000000000000
0000000000011111111111111111000000000000000000000000000000000111111111111111110000000000000000000000
0000000000001111111111110000000000000000000000000000000000000111111111111111110000000000000000000000
0000000000001111111111110000000000000000000000000000000000000111111111111111110000000000000000000000
0000000000001111111111100000000000000000000000000000000000000111111111111111110000000000000000000000
0000000000000111111110000000000000000000000000000000000000000001111111100000000000000000000000000000
0000000000000111111100000000000000000000000000000000000000000001111111100000000000000000000000000000
0000000000000111111000000000000000000000000000000000000000000001111111100000000000000000000000000000
0000000000000011110000000000000000000000000000000000000000000001111111100000000000000000000000000000
0000000000000001100000000000000000000000000000000000000000000000011000000000000000000000000000000000
0000000000000000000000000000000000000000000000000000000000000000011000000000000000000000000000000000
0000000000000000000000000000000000000000000000000000000000000000000000000000000000000000000000000000
0000000000000000000000000000000000000000000000000000000000000000000000000000000000000000000000000000
0000000000000000000000000000000000000000000000000000000000000000000000000000000000000000000000000000
0000000000000000000000000000000000000000000000000000000000000000000000000000000000000000000000000000
0000000000000000000000000000000000000000000000000000000000000000000000000000000000000000000000000000
0000000000000000000000000000000000000000000000000000000000000000000000000000000000000000000000000000
0000000000000000000000000000000000000000000000000000000000000000000000000000000000000000000000000000
0000000000000000000000000000000000000000000000000000000000000000000000000000000000000000000000000000
0000000000000000000000000000000000000000000000000000000000000000000000000000000000000000000000000000
0000000000000000000000000000000000000000000000000000000000000000000000000000000000000000000000000000
0000000000011100000000000000000000000000000000000000000000000000000000000000000000000000000000000000
0000000000111111000000000000000000000000000000000000000000000000000000000000000000000000000000000000
0000000000111000000000000000000000000000000000000000000000000000000000000000000000000000000000000000
0000000000000000000000000000000000000000000000000000000000000000000000000000000000000000000000000000
0000000000000000000000000000000011100000000000000000000000000000000000000000000000000000000000000000
0000000000000000000000000000000111110000000000000000000000000000000000000000000000000000000000000000
0000000000011111111000000000000011100000000000000000000000000000000000000000000000000000000000000000
0000000000001111111111100000000000000000000000000000000000000000000000000000000000000000000000000000
0000000000000000000000000000000000000000000000000000000000000000000000000000000000000000000000000000
0000000000000000000000000000000000000000000000000000000000000000000000000000000000000000000000000000
0000000000000000000000000000000000000000000000000000000000000000000000000000000000000000000000000000
0000000000000000000000000000000000000000000000000000000000000000000000000000000000000000000000000000