0000000000000000000000011111000000000000000000000000011111000000000000000000000000011111000000000000
0000000000000000000000000111000000000000000000000000000111000000000000000000000000111111000000000000
0000000000000000000000000011000000000000000000000000000011100000000000000000000000111111000000000000
0000000000000000000000000000000000000000000000000000000001100000000000000000000000011110000000000000
0000000000000000000000000000000000000000000000000000000001110000000000000000000000001100000000000000
0000000000000000000000000000000000000000000000000000000001111000000000000000000000000000000000000000
0000000000000000000011000000000000000000000000000000000001111000000000000000000000000000000000000000
0000000000000000000111000000000000000000000000000000000000111000000000000000000000000000000000000000
0000000000000000000110000000000000000000000000000000000000000000000000000000000000000000000000000000
0000000000000000000000000000000000000000000000000000000000000000000000000000000000000000000000000000
0000000000000000000000000000000000000000000000000000000000000000000000000000000000000000000000000000
0000000000000000000000000000000000000000011000000000000000000000000000000000000000000000000000000000
0000000000000000000000000000000000000000011100000000000000000000000000000000000000000000000000000000
0000000000000000000000000000000000000000001000000000000000000000000000000000000000000000000000000000
0000000000000000000000000000000000000000000000000000000000000000000000000000000000000100000000000000
0000000000000000000000100000000000011100000000000000000000000000000000000000000000011111000000000000
0000000000000000000011111000000000111110000000000000000000000000000000000000000000111111100000000000
0000000000000000000011111100000000111111000000000000000000000000000000000001111111111111110000000000
0000000000000000000111111110000001111111000000000000000000000000000000001111111111111111110000000000
0000000000000000001111111110000011111111000000000000000000000000000000011111111111111111110000000000
1000000000000000011111111111111111111111000000000000000000000000000000011111111111111111110000000000
1100000000000000111111111111111111111110000000000000000000000000000000111111111111111111110000000000
1110000000000000111111111111111111111000000000000000000000000000000001111111111111111111110000000000
1100000000000001111111111111111111110000000000000000000000000000000011111000011111111111111000000000
1100000000000001111111111111111111100000000000000000000000000000001111110000000011111111111000000000
1100000000000001111111111111111110000000000000000000000000000000111111110000000001111111110000000000
1100000000000000111111111111100000000000000000000000000000000001111111110000000000111111100000000000
0000000000000000111111111111000000000000000000000000000000000000111111100000000000011111000000000000
0000000000000000011111111111000000000000000000000000000000000000000111100000000000001111000000000000
0000000000000000001111111111000000000000000000000000000000000000000011100000000000000110000000000000
0000000000000000001111111111000000000000000000000000000000000000000011100000000000000110000000000000
0000000000000000001111111111000000000000000000000000000000000000000011110000000000000010000000000000
0000000000000000001111111110000000000000000000000000000000000000000001111000000000000000000000000000
0000000000000000001111111100000000000000000000000000000000000000000001111100000000000000000000000000
0000000000000000001111111000000000000000000000000000000000000000000001111110000000000000000000000000
0000000000000000001111100000000000000000000000000000000000000000000011111110000000000000000000000000
0000000000000000001111000000000000000000000000000000000000000000000011111110000000000000000000000000
0000000000000000011111000000000000000000000000000000000000000000000011111110000000000000000000000000
0000000000000000011110000000000000000000000000000000000000000000000011111111000000000000000000000000
0000000000000000011110000000000000000000000000000000000000000000000011111111000000000000000000000000
0000000000000000011100000000000000000000000000000000000000000000000011111111100000000000000000000000
0000000000000000000000000000000000000000000000000000000000000000000001111111110000000000000000000000
0000000000000000000000000000000000000111000000000000000000000000000000111111111000000000000000000000
0000000000000000000000000000000000011110000000000000000000000000000000000110000000000000000000000000
0000000000000000000000000000000000111100000000000000000000000000000000000000000000000000000000000000
0000000000000000000000000000000001111100000000000000000000000000000100000000000000000000000000000000
0000000000000000000000000000000111111100000000000000000000000000001110000000000000000000000000000000
0000000000000000000000000000000111111100000000000000000000000000001110000000000000000000000000000000
0000000000000000000000000000000111111100000000000000000000000000011100000000000000000000000000000000
0000000000000000000000000000000111111100000000000000000000000000000000000000000000000001111111000000
0000000000000000000000000000000111111110000000000000000000000000000000000000000000000011111111110000
0000000000000000000000000000000111111110000000000000000000000000000000000000000000000111111111111000
0000000000000000000000000000000111111100000000000000000000000000000000000000000000001111111111111000
0000000000000000000000000000001111111100000000000000000000000000000000000000000000001111111111111000
0000000000000000000000000000001111111000000000000000000000000000000000000000000000011111111111110000
0010000000000000000000000000001111111000000000000000000000000000000000000000000000111111111111110000
0111100011110000000000000000001111110000000000000001100000000000000000000000000011111111111111100000
0111111111111000000000000000001111100000000000000011110000000000000000000000000011111111111111000000
0111111111111000000000000000000000000000000000000011100000000000000000000000000111111100111100000000
0011111111111100000000000000000000000000000000000011100000000000000000000000000111110000000000000000
0001111111111100000000000000000000000000000000000011100000000000000000000000000011100000000000000000
0000111111111100000000000000000000000000000000000111100000000000000000000000000000000000000000000000
0000111111111100000000000000000000000000001111111111000000000000000000000000000000000000000000000000
0000111111111000000000000000000000000000011111111111000000000000000000000000000000000000000000000000
0000111111110000000000000000000000000000011111111110000000000000000000000000000000000000000000000000
0000011111100000000000000000000000000000001111111110000000000000000000000000000000000000000000000000
0000000010000000000000000000000000000000000111111110000000000000000000000000000000000000000000000000
0000000000000000000000000000000000000001110001111110000000000000000000000000000000000000000000000001
0000000000000000000000000000000000000011110000111100000000000000000000000000000000000000000000000001
0000000000000000000000000000000000001111110000000000000000000000000000000000000000010000000000000001
0000000000000000000000000000000000001111110000000000000000000000000000000000000000111100000010000000
0000000000000000010000000000000000011111110000000000000000000000000000000000000000111110001111100000
0000000000000000000000000000000000011111110000000000000000000000000000000000000000111110001111111000
0000000000000000000000000000000000011111111000000000000000000000000000000000000000111100000111111100
0000000000000000000000000000000000111111111000000000000000000000000000000000000000011100000011111100
0000000000000000000000000000000001111111111000000000000000000000000000000000000000011000000001111100
0000000000000000000000000000000111111111111000000000000000000000000000000000000000010000000000010000
0000000000000000000000000000001111111111111000000000000000000000000000000001111111110000000000000000
0000000000000000000000000000011111111111111000000000000000000000000000000011111111110000000000000000
0000000000000000000000000000011111111111110000000000000000000000000000000111111111110000000000000000
0000000000000000000000000000011111111111110000000000000000000000000000001111111111110000000000000000
0011110000000000000000000000000000000111100000000000000000000001110000011111111111110000000000000000
0111110000000000000000000000000000000000000000000000000000000000111000011111111111110000000000000000
1111100000000111000000000000000000000000000000000000000000000000011100111111111111111000000000000000
1111100000000110000000000000000000000000000000000000000000000000011100111111111111111000000000000000
1111000000000000000000000000000000000000000000011100000000000000000000011111111111111100000000000000
0000000000000000000000000000000000000000000000111100000000000000000000000111111111111110000000000000
0000000000000000000000000000000000000000000000111000000000000000000000000000111111111110000000000000
0000000000000000000000000000000000000000000000000000000000000000110000000000011111111110000000000000
0000000000000000000000000000000000000000000000000000000000000001111000000000001111111100000000000000
0000000000000000000000000000000000000000000000000000000000000011111100000000000000010000000000000000
0000000000000000000000000010000000000000000000000000000000000011111100000000000000000000000000000000
0000000000000000000000000000000000000000000000000000000000000111111110000000000000000000000000000000
0000000000000000000000000000000000000000000000000000000000000111111100000000000000000000000000000000
0000000000000000000000000000000000000000000000000000000000001111111100000000000000000000000000000000
0000000000000000000000000000000000100000000000000000000000001111111000000000000000000000000000000000
0000000000000000000000000000000001100000000000000000000000000011110000000000000000000000000000000000
0000000000000000000000000000000000000000000000000000000000000000111000000000000000000000000000000000
0000000000000000000000000000000000000000000000000000000000000000011110000000000000000000000000000000
0000000000000000000000000000000000000000000000000000000000000000011111100000000000000000000000000000